1111111111111111111
10000000000000100E1
1000110010000010001
1111100010000010001
1P00000010000000011
1111111111111111111
