1111111111111111111
1C00000000C00010001
1000110010000010001
111110001000001C001
1P000000100C00C0011
1111111111111111111
