1111111111111111111
1C00000000C000100E1
1000110010000010001
111110001000001C001
10000000100C00C0011
1111111111111111111
