1111111111111111111
1C00000000C000100E1
10001100100000100001
111110001000001C001
1P000000100C00C0011
1111111111111111111
