11111111111111111111
10C000001000000000E1
11110110000000111111
10000010111111100001
100000000P0000000001
10000000000011111001
1000000000001CCC1001
10C000000000100000x1
11111111111111111111
